start: L
accept: Sa
reject: Sr
blank: #
L 0 -> L 0 >
L 1 -> L 1 >
L A -> WR A <
L B -> WR B <
L # -> WR # <
WR 0 -> R A <
WR 1 -> R B <
WR A -> CA x >
WR B -> CB x >
WR # -> Sa # >
WL 0 -> L A >
WL 1 -> L B >
WL A -> Sr A ^
WL B -> Sr B ^
R 0 -> R 0 <
R 1 -> R 1 <
R A -> WL A >
R B -> WL B >
R # -> WL # >
CA A -> CA A >
CA B -> CA B >
CA C -> CA C >
CA # -> LA # <
LA A -> W # <
LA B -> Sr B ^
CB A -> CB A >
CB B -> CB B >
CB C -> CB C >
CB # -> LB # <
LB A -> Sr A ^
LB B -> W # <
W A -> W A <
W B -> W B <
W C -> W C <
W x -> WR C <
W # -> Sa # >
